****************************
*p     ***+ 111            *
***** **=*+ +++++**===1***1*
* 1 +  *=    +1  1 ===1***1*
* 1 +  *=    + +++ +       *
*   +  *=    + +1+ +    ===*
*      *=    + + +      =f=*
* ******=    + 1 =*****== =*
* =======    ++* **    1  =*
*         11 +         ====*
****************************