================================
*                              *
*                              *
*                     1        *
*   p                ***       *
*                              *
*                           f  *
++++++++++++++++++++++++++++++++
++++++++++++++++++++++++++++++++
++++++++++++++++++++++++++++++++
